000000000000000000000000000000000000000000000000000000000000
000000000002200000000000000000000000000000000000000000000000
000000000000200000000222222000000000000000000000000000000000
000000000000020000002000000220020000000000000000000100000000
000000000000002000000000000002002000000000000100000000000000
000000000220000200020000000000000220000000000000001000000000
000000000002000200020000000000000000000000100000000000000000
000000000000220020000000000000020002000000000010000000000000
000000000220002002222000000000020000200200000000010000000000
000000000002002000002200000000220002000000000000000000000000
000000020200200202002200000000200000000000000100000000000000
000000000000020002000000200002000020000000020000000000000000
000000220020000002000000022220000000000000000000000001000000
000002222000000020000000000000000000000002000000100000000000
000000000000000000000000000000000000000000000000000000000000
000022000000000202000000000000000000000000010002000000000000
000022202000000000000000000000000000000000000000000001000000
000000020000202000000000000000000000000000000000000000000000
000222000000000000000000000000000000000000000000000000000000
111111111111111111111111111111111111111111111111111111111111
