000000000000000000000000000000000000000000000000000000000000000000000000000000000000000000
000000000000000000000000000000000000000000000000000000000000000000000000000000000000000000
000000000000000000000000000000000000000000000000000000000000000000000000000000000000000000
000000000000000000000000000000000000000000000000000000000000000000000000000000000000000000
000000000000000000000000000000000000000000000000000000000000000000000000000000000000000000
000000000000000000000000000000000000000000000000000000000000000000000000000000000000000000
000000000000000000000000000000000000000000000000000000000000000000000000000000000000000000
000000000000000000000000000000000000000000000000000000000000000000000000000000000000000000
000200000000000000000000000000000000000000000000000000000000000000000000000000000000000000
000000000000000000000000000000000000000000000000000000000000000000000000000000000000000000
000200000000000000000000000000002222200000000000000000000000000000000000000000000000000000
000000000000000000000000000000000000000000000022200000000000000001000000200100000000000000
000000000000000000002200000000222220000000000000000022222222222001111110001102000000000000
000000000000000000000000000000000000222000000222200000000000000021111111111100200000000000
000000000000000020022220000022000000000000000000000000000000000001111111111100020000000000
000000000000000000000000000000000000000000022000000000220022000001111111111100000000000000
441111111112222111111111111111111111111111111111111111111111111111111111111111111111111111
111111111114441111111111111111111111111111111111111111111111111111111111111111111111111111
000000000000000000000000000000000000000000000000000000000000000000000000000000000000000000
000000000000000000000000000000000000000000000000000000000000000000000000000000000000000000
