000000000000000000000000000000000000000000000000000000000000
000000000000000000000000000000000000000000000000000000000000
000000000000000000000000000000000000000000000000000000000000
000000000000000000000000000000000000000000000000000000000000
000000000000000000000000000000000000000000000000000000000000
000000000000000000000000000000000000000000000000000000000000
000000000000002222000000000000000000000000000200000000000000
000000000000000000022220000000000000000000000000000000000000
000000000000000000000000222000002000222220002000000000000000
000000000000000000000000000000000000020000000000002200222000
000220000000002220002000002000000020000000000000000000000000
000000000000000000000000000000000000020000000200020000000000
000000000000000000200002200000000000020000000000000000000000
000002200000002000000000000000000000000010101001000000000000
000000000000000000000000000000022222001111111111111101100000
001111000000021101100000000000200000011111111111111101110200
001111000030001111111110000000000000111111111111111141111111
111111111111111111111111111111111111111111111111111111111111
111111111111111111111111111111111111111111111111111111111111
111111111111111111111111111111111111111111111111111111111111
