000000000000000000000000000000000000000000000000000000000000
000000000000000000000000000000000000000000000000000000000000
000000000000000000000000000000000000000000000000000000000000
000000000000000000000000000000000000000000000000000000000000
000000000000000000000000000000000000000000000000000000000000
000000200000022000000000000000000000000000000000000000000000
000000000000000020000000000000000000000000000000000000000000
000000000000000000000000000000000000000000000000000000000022
000000000000000000200000000000000000000000000000000000000000
000000000000000000000000000000000220000000222000000000002222
000000000000000022222200000000000000000000000000000000000000
000000000220002000000000000002000000022220000000000000222222
000002200000000000000000000200000000002000000000000000000000
000000000000000002000000000000000000002000000000000022222222
000002000000000000002000000200000000022000000000000000000000
000002000000000222220000000000000000000000000000002222222222
000002000000000000000022000000000002200000000000000000000000
000002000000002000000000002222000002202200000000222222222222
000002000000000000000002000000000002200000000000000000000000
111111111111111111111111111111111111111111111111111111111111
